{
  "width": 12,
  "height": 10,
  "tileWidth": 64,
  "tileHeight": 32,
  "layers": [
    {
      "name": "floor",
      "data": [
        1,1,1,1,1,1,1,1,1,1,1,1,
        1,1,1,1,1,1,1,1,1,1,1,1,
        1,1,1,2,2,2,2,2,2,1,1,1,
        1,1,1,2,0,0,0,0,2,1,1,1,
        1,1,1,2,0,0,0,0,2,1,1,1,
        1,1,1,2,0,0,0,0,2,1,1,1,
        1,1,1,2,2,2,2,2,2,1,1,1,
        1,1,1,1,1,1,1,1,1,1,1,1,
        1,1,1,1,1,1,1,1,1,1,1,1,
        1,1,1,1,1,1,1,1,1,1,1,1
      ]
    }
  ],
  "objects": [
    {
      "name": "spawn",
      "type": "playerSpawn",
      "tile": { "col": 5, "row": 4 }
    }
  ]
}
